-22
22
-11
14
000000000000000000000000000000000000000000000
000000000000000000000000000000000000000000000
011111111111111111111111111111111111111111000
010010100000000000000000000000000000000001000
010000000000000000000000000000000000000001000
010000000000000000000000000000000000000001000
010000000000000000000000000000000000000001000
010000000000011111100000000000000000000001000
010000000000011111100111111100000000000001000
010000000000011111100111111100000000000001000
010000000000011111100111111100000000000001000
010000000000011111100111111100000000000001000
010000000000011111110111111100000000000001000
010000000000011111110111011100000000000001000
010000000000011111110000000000000000000001000
010000000000000000000000000000000000000001000
010000000000000000000110000000000000000001000
010000000000000000000000000000000000000001000
010000000000000000000000000000000000000001000
010000000000000000000000000000000000000001000
010000000000000000000000000000000000000001000
010000000000000000000000000000000000000001000
010000000000000000000000000000000000000001000
010000000000000000000000000000000000000001000
010000000000000000000000000000000000000001000
011111111111111111111111111111111111111111000
