-19
18
-9
11
01010000000000000000000000000000000000
11011111111111111111111111111111111110
00000000000000000000000000000000000000
00000000000000000000000000000000000000
00000000001111110000000000000000000000
00000000001111110011111110000000000000
00000000001111110011111110000000000000
00000000001111110011111110000000000000
00000000001111110011111110000000000000
00000000001111111011111110000000000000
00000000001111111011111110000000000000
00000000001111111011111110000000000000
00000000000000000000000000000000000000
00000000000000000011000000000000000000
00000000000000000000000000000000000000
00000000000000000000000000000000000000
00000000000000000000000000000000000000
00000000000000000000000000000000000000
00000000000000000000000000000000000000
00000000000000000000000000000000000000
00000000000000000000000000000000000000
