-9
6
-2
8
0000000000000000
1111110000000000
1111110011111110
1111110011111110
1111110011111110
1111110011111110
1111111011111110
1111111011111110
1111111011111110
0000000000000000
0000000011000000
